|-------|
|...c...|
|.Y.n...|
|.....Y.|
|.Y.....|
|.....Y.|
|.Y.....|
|.....Y.|
|.Y.....|
|-->->--|
