|-|---|---|---|---||
|+-+++-+++-+++-+++-|
|+++|+++|+++|+++|++|
|+-----------------|
|++++++++++++++++++|
|-----------------+|
|++++++++++++++++++|
|+-----------------|
|++++++++++++++++++|
>++++++++++++++++++|
|++++++++++++++++++|
|........++........|
|........++........|
|Y.Y.Y.Y.++.Y.Y.Y.Y|
|.T.T.T.T++T.T.T.T.|
|.++++++O++0++++++.|
|.+lkkr+|--|+lkkr+.|
|.+lkkr+||||+lkkr+.|
|.++++++||||++++++.|
||||||||||||||||||||
