|--!---!---!---!--|
|+++++++++++++++++|
|+++++++++++++++++|
|+++++++++++++++++|
|+++++++++++++++++|
|+++++++++++++++++|
|+++++++++++++++++|
|+++++++++++++++++|
|+++++++++++++++++|
|+++++++++++++++++|
|+++++++++++++++++|
|+++++++++++++++++|
|+++++++++++++++++|
|+++++++++++++++++|
|+++++++++++++++++|
|+++++++++++++++++|
|+++++++++++++++++|
|+++++++++++++++++|
|+++++++++++++++++|
|+++++++++++++++++|
|+++++++++++++++++|
|+++++++++++++++++|
|+++++++++++++++++|
|+++++++++++++++++|
|+++++++++++++++++|
|+++++++++++++++++|
|+++++++++++++++++|
|+++++++++++++++++|
|+++++++++++++++++|
-------------------
