XXXXXXXXXX
X........X
X..Y.....X
X........X
X.....Y..X
X........X
X........X
X......Y.X
X...Y....X
XXXXXXXXXX
