XXXXXXXXXXXXXXXXXXXX
X..................X
X..................X
X..................X
X.YYYYYYYYYYYYYYYY.X
X..................X
X..................X
X..................X
X..................X
X..................>
X.....Y............X
X..................X
X.Y................X
X.YYYYYYYYYYYYYYYY.X
X..................X
X.....Y............X
X.................YX
X....Y.............X
X.Y................X
XXXXXXXXXXXXXXXXXXXX
