|-------|
|..+c+..|
|.Y+k+..|
|..+++Y.|
|.Y+++..|
|..+++Y.|
|.Y+++..|
|..+++Y.|
|.Y+++..|
|-->->--|
